...........X...G
..X........X....
S.X...X....X.X..
..X..X.......X..
.....XX...X.XX..
..........X.....
..X.............
.....XXXXXXXX...