.........G
..........
.XXXXXXXX.
..........
.........S