.........G
..........
.XXXXXXXXX
..........
.........S